##############################                                                            ##############################
#                          #                                                                                           #
#                          #                                                                                           #
#                          #                                                                                           #
#                          #                                                                                           #
#                          #                                                                                           #
#                          #                                                                                           #
#                          #                                                                                           #
#                          #                                                                                           #
#                          #                                                                                           #
#                          #                                                                                           #
#                          #                                                                                           #
#                          #                                                                                           #
#                          #                         @                   #                                             #
#                          #














                                                        
 














#                                                                                                                      #
#                                                                                                                      #
#                                                                                                                      #
#                                                                                                                      #
#                                                                                                                      #
#                                                                                                                      #
#                                                                                                                      #
#                                                                                                                      #
#                                                                                                                      #
#                                                                                                                      #
#                                                                                                                      #
#                                                                                                                      #
#                                                                                                                      #
#                                                                                                                      #
##############################                                                            ##############################