#                                      ########################################
#                                      #                                      
#                                      #                                      
#                                      #                                      
#                                      #                                      
#                                      #                                      
#                                      #                                      
#                                      #                      @               
#                                      #                                      
#                                      #                                      
#                                      #                                      
#                                      #                                      
#                                      #                                      
#                                      #                                     
###############################################################################
                                       #                                      #
                                       #                                      #
                                       #                                      #
                                       #                                      #
                                       #                                      #
                                       #                                      #
                                       #                                      #
                                       #                                      #
                                       #                                      #
                                       #                                      #
                                       #                                      #
                                       #                                      #
                                       #                                      #
                                       #                                      #
########################################