##################################################
#                                                #
#                                                #
#                                                #
#                                                #
#                                                #
#                 O                              #
#                                                #
#                                                #
#                                                #
#                                                #
#                                                #
##################################################